........*......*
.O..............
^^.....^^.......
===..=====....==
vvv.............
......***....===
................
===.-......=....
vPv.....*...==..
...............*
..?.^...^.......
.====.====..===.
120
Spikes are something
new, right?

As usual - don't
touch them!

But you knew that
already, I guess...