...............O
*...*....*......
==...-.......===
.*..............
...==...*.....*.
................
......==...-..==
**.............*
==.-......==....
*.........*...==
....P..?........
================
120
Moving platforms can
help you.

Or not.