..*...*...*...O.
................
==.....-.....===
=...............
=...==..........
=.*.=.....======
=...=........v*v
=.*.====........
=...=*......^...
=.*.=.....=====.
=...=.P.?......*
=========....===
120
Have you ever tried
walljumping?

It's all about
timing in this level!