................
.O.....W......*.
..w.......==....
*...===*........
..........W.....
==......-..==.*.
....w.*.........
.*............==
..w.............
..===..==..=...*
P.?.............
===..===.-....==
120
Clouds slow you down.

So you'd better
avoid them!