................
.*...*.........O
................
.==.....*.....==
................
...*.==....==.*.
...*............
...*...==.......
...*............
.......====.*...
......P?.......*
===..===..===..=
120
Gaps in the ground!

Be careful!

And again, don't
leave the level...