*.............O.
^==....W...===..
....*====^^.....
==..............
.......>........
..===...........
...........w....
*.....==......*.
.............^..
...==........==.
.......*.....P.?
===^===^========
120
This level was created
by my little son,
Benjamin ;-)

Try to beat it!