*.............O.
==......w....*..
..===........===
..*>...====.....
.===..W.......*.
.....==......P..
...*.....==.....
.>........*.==..
..>.*..==.......
..===...........
.............?..
...====.==..====
120
Watch the crows!

And the clouds!

And the gaps!